1111111111111111111111111
1P000000000000000000000C1
1011111101111111101111101
1000000101000000101000001
1111110101011111101011111
1000000101010000001010001
1011111101010111111010101
1010000001010100000010101
1010111111010101111110101
1010100000000101000000101
1010101111111101011111101
1010101000000001010000101
1010101011111111010110101
1010000010000000010110101
1011111110111111110110101
1000000000100000000110001
1111111110101111111111101
1C00000010101000000000001
1011111010101011111111101
1010001010101010000000101
1010101010101010111110101
1010101000101010100000101
1010111111101010101111101
1000000000001E00100000C01
1111111111111111111111111