111111111111111
1P0000100000001
100001000010001
1C0001000010C01
1000010E0100001
1C00010001000C1
100001000010001
1000C1000100001
10000000C000001
111111111111111