1111111111111
10000E00000P1
10000C0000011
1111111111111