1111111111111
10000E00000P1
10000C0000001
1111111111111