1111111111111
1000E000C00P1
1111111111111