1111111111111
10E0C000011P1
1000000010111
1111111111111